County,County Name,AEA,District #,District Name,Grade8.Not Proficient,Grade8.Proficient,Grade8.Total Tested,Grade8.% Proficient
42,Hardin,7,9,AGWSR Comm School District,4,31,35,88.6
39,Guthrie,11,18,Adair-Casey Comm School District,4,14,18,77.8
25,Dallas,11,27,Adel DeSoto Minburn Comm School District,15,107,122,87.7
75,Plymouth,12,63,Akron Westfield Comm School District,7,26,33,78.8
11,Buena Vista,5,72,Albert City-Truesdale Comm School District,0,0,0,
68,Monroe,15,81,Albia Comm School District,18,70,88,79.5
57,Linn,10,99,Alburnett Comm School District,13,32,45,71.1
42,Hardin,7,108,Alden Comm School District,0,0,0,
55,Kossuth,5,126,Algona Comm School District,20,75,95,78.9
3,Allamakee,1,135,Allamakee Comm School District,20,96,116,82.8
12,Butler,7,153,North Butler Comm School District,3,33,36,91.7
11,Buena Vista,5,171,Alta Comm School District,0,0,0,
85,Story,11,225,Ames Comm School District,29,244,273,89.4
53,Jones,10,234,Anamosa Comm School District,27,72,99,72.7
49,Jackson,9,243,Andrew Comm School District,5,9,14,64.3
77,Polk,11,261,Ankeny Comm School District,67,704,771,91.3
12,Butler,7,279,Aplington-Parkersburg Comm School District,7,46,53,86.8
32,Emmet,5,333,North Union Comm School District,0,0,0,
24,Crawford,12,355,Ar-We-Va Comm School District,3,13,16,81.3
15,Cass,13,387,Atlantic Comm School District,16,96,112,85.7
5,Audubon,11,414,Audubon Comm School District,4,33,37,89.2
18,Cherokee,12,423,Aurelia Comm School District,16,34,50,68
78,Pottawattamie,13,441,AHSTW Comm School District,7,38,45,84.4
85,Story,11,472,Ballard Comm School District,33,98,131,74.8
47,Ida,12,504,Battle Creek-Ida Grove Comm School District,0,0,0,
50,Jasper,11,513,Baxter Comm School District,6,21,27,77.8
38,Grundy,7,540,BCLUW Comm School District,4,33,37,89.2
87,Taylor,13,549,Bedford Comm School District,4,23,27,85.2
6,Benton,10,576,Belle Plaine Comm School District,8,26,34,76.5
49,Jackson,9,585,Bellevue Comm School District,4,38,42,90.5
99,Wright,7,594,Belmond-Klemme Comm School District,11,44,55,80
16,Cedar,9,603,Bennett Comm School District,0,0,0,
6,Benton,10,609,Benton Comm School District,11,98,109,89.9
82,Scott,9,621,Bettendorf Comm School District,67,275,342,80.4
90,Wapello,15,657,Eddyville-Blakesburg- Fremont CSD,18,56,74,75.7
77,Polk,11,720,Bondurant-Farrar Comm School District,28,102,130,78.5
8,Boone,11,729,Boone Comm School District,32,98,130,75.4
84,Sioux,12,747,Boyden-Hull Comm School District,10,44,54,81.5
41,Hancock,7,819,West Hancock Comm School District,6,37,43,86
79,Poweshiek,7,846,Brooklyn-Guernsey-Malcom Comm School District,2,30,32,93.8
95,Winnebago,7,873,North Iowa Comm School District,4,15,19,78.9
29,Des Moines,15,882,Burlington Comm School District,86,162,248,65.3
15,Cass,13,914,CAM Comm School District,13,45,58,77.6
48,Iowa,7,916,CAL Comm School District,6,8,14,57.1
23,Clinton,9,918,Calamus-Wheatland Comm School District,9,27,36,75
23,Clinton,9,936,Camanche Comm School District,18,59,77,76.6
90,Wapello,15,977,Cardinal Comm School District,15,21,36,58.3
91,Warren,11,981,Carlisle Comm School District,28,111,139,79.9
14,Carroll,11,999,Carroll Comm School District,20,92,112,82.1
7,Black Hawk,7,1044,Cedar Falls Comm School District,55,310,365,84.9
57,Linn,10,1053,Cedar Rapids Comm School District,404,679,1083,62.7
57,Linn,10,1062,Center Point-Urbana Comm School District,8,105,113,92.9
4,Appanoose,15,1071,Centerville Comm School District,27,75,102,73.5
56,Lee,15,1079,Central Lee Comm School District,8,60,68,88.2
22,Clayton,1,1080,Central Comm School District,4,26,30,86.7
23,Clinton,9,1082,Central DeWitt School District,15,72,87,82.8
57,Linn,10,1089,Central City Comm School District,13,16,29,55.2
27,Decatur,13,1093,Central Decatur Comm School District,22,24,46,52.2
60,Lyon,12,1095,Central Lyon Comm School District,8,46,54,85.2
59,Lucas,15,1107,Chariton Comm School District,30,44,74,59.5
34,Floyd,7,1116,Charles City Comm School District,28,85,113,75.2
24,Crawford,12,1134,Charter Oak-Ute Comm School District,7,13,20,65
18,Cherokee,12,1152,Cherokee Comm School District,10,56,66,84.8
73,Page,13,1197,Clarinda Comm School District,11,53,64,82.8
99,Wright,5,1206,Clarion-Goldfield-Dows Comm School District,13,55,68,80.9
20,Clarke,13,1211,Clarke Comm School District,23,65,88,73.9
12,Butler,7,1215,Clarksville Comm School District,6,14,20,70
21,Clay,5,1218,Clay Central-Everly Comm School District,9,12,21,57.1
52,Johnson,10,1221,Clear Creek Amana Comm School District,29,136,165,82.4
17,Cerro Gordo,7,1233,Clear Lake Comm School District,14,81,95,85.3
23,Clinton,9,1278,Clinton Comm School District,69,156,225,69.3
50,Jasper,11,1332,Colfax-Mingo Comm School District,8,37,45,82.2
57,Linn,10,1337,College Comm School District,99,300,399,75.2
85,Story,11,1350,Collins-Maxwell Comm School District,3,19,22,86.4
85,Story,11,1359,Colo-NESCO Comm School District,5,22,27,81.5
58,Louisa,9,1368,Columbus Comm School District,28,23,51,45.1
14,Carroll,11,1413,Coon Rapids-Bayard Comm School District,11,17,28,60.7
2,Adams,13,1431,Corning Comm School District,0,0,0,
78,Pottawattamie,13,1476,Council Bluffs Comm School District,219,383,602,63.6
88,Union,13,1503,Creston Comm School District,27,79,106,74.5
25,Dallas,11,1576,Dallas Center-Grimes Comm School District,23,176,199,88.4
29,Des Moines,15,1602,Danville Comm School District,9,37,46,80.4
82,Scott,9,1611,Davenport Comm School District,407,572,979,58.4
26,Davis,15,1619,Davis County Comm School District,29,45,74,60.8
96,Winneshiek,1,1638,Decorah Community School District,15,107,122,87.7
23,Clinton,9,1675,Delwood Comm School District,0,0,0,
24,Crawford,12,1701,Denison Comm School District,34,96,130,73.8
9,Bremer,7,1719,Denver Comm School District,1,61,62,98.4
77,Polk,11,1737,Des Moines Independent Comm School District,834,1120,1954,57.3
80,Ringgold,13,1782,Diagonal Comm School District,small N,small N,small N,small N
38,Grundy,7,1791,Dike-New Hartford Comm School District,11,52,63,82.5
31,Dubuque,1,1863,Dubuque Comm School District,186,597,783,76.2
7,Black Hawk,7,1908,Dunkerton Comm School District,8,26,34,76.5
43,Harrison,13,1917,Boyer Valley Comm School District,8,29,37,78.4
16,Cedar,9,1926,Durant Comm School District,15,35,50,70
99,Wright,5,1944,Eagle Grove Comm School District,17,30,47,63.8
61,Madison,11,1953,Earlham Comm School District,2,38,40,95
10,Buchanan,7,1963,East Buchanan Comm School District,7,40,47,85.1
49,Jackson,9,1965,Easton Valley Comm School District,8,27,35,77.1
64,Marshall,7,1968,East Marshall Comm School District,12,33,45,73.3
88,Union,13,1970,East Union Comm School District,9,33,42,78.6
3,Allamakee,1,1972,Eastern Allamakee Comm School District,3,15,18,83.3
97,Woodbury,12,1975,River Valley Comm School District,15,25,40,62.5
28,Delaware,1,1989,Edgewood-Colesburg Comm School District,7,30,37,81.1
42,Hardin,7,2007,Eldora-New Providence Comm School District,0,0,0,
74,Palo Alto,5,2088,Emmetsburg Comm School District,18,42,60,70
48,Iowa,10,2097,English Valleys Comm School District,5,16,21,76.2
73,Page,13,2113,Essex Comm School District,2,15,17,88.2
32,Emmet,5,2124,Estherville Lincoln Central Com Sch Dist,29,56,85,65.9
83,Shelby,11,2151,Exira-Elk Horn- Kimballton Comm Sch Dist,10,11,21,52.4
51,Jefferson,15,2169,Fairfield Comm School District,22,103,125,82.4
95,Winnebago,7,2295,Forest City Comm School District,15,68,83,81.9
94,Webster,5,2313,Fort Dodge Comm School District,114,131,245,53.5
56,Lee,15,2322,Fort Madison Comm School District,40,89,129,69
36,Fremont,13,2369,Fremont-Mills Comm School District,6,24,30,80
47,Ida,12,2376,Galva-Holstein Comm School District,0,0,0,
41,Hancock,7,2403,Garner-Hayfield-Ventura Comm School District,17,53,70,75.7
60,Lyon,12,2457,George-Little Rock Comm School District,7,24,31,77.4
85,Story,11,2466,Gilbert Comm School District,4,113,117,96.6
46,Humboldt,5,2493,Gilmore City-Bradgate Comm School District,0,0,0,
38,Grundy,7,2502,Gladbrook-Reinbeck Comm School District,9,22,31,71
65,Mills,13,2511,Glenwood Comm School District,30,123,153,80.4
14,Carroll,11,2520,Glidden-Ralston Comm School District,6,12,18,66.7
74,Palo Alto,5,2556,Graettinger-Terril Comm School District,4,20,24,83.3
1,Adair,13,2673,Nodaway Valley Comm School District,19,36,55,65.5
86,Tama,7,2682,GMG Comm School District,5,31,36,86.1
79,Poweshiek,7,2709,Grinnell-Newburg Comm School District,16,85,101,84.2
15,Cass,13,2718,Griswold Comm School District,8,27,35,77.1
38,Grundy,7,2727,Grundy Center Comm School District,7,35,42,83.3
39,Guthrie,11,2754,Guthrie Center Comm School District,0,0,0,
22,Clayton,1,2763,Clayton Ridge Comm School District,16,35,51,68.6
48,Iowa,10,2766,H-L-V Comm School District,4,20,24,83.3
36,Fremont,13,2772,Hamburg Comm School District,small N,small N,small N,small N
35,Franklin,7,2781,Hampton-Dumont Comm School District,15,58,73,79.5
83,Shelby,13,2826,Harlan Comm School District,23,112,135,83
89,Van Buren,15,2834,Harmony Comm School District,0,0,0,
30,Dickinson,5,2846,Harris-Lake Park Comm School District,6,28,34,82.4
71,O'Brien,12,2862,Hartley-Melvin-Sanborn Comm School District,12,30,42,71.4
92,Washington,10,2977,Highland Comm School District,6,35,41,85.4
75,Plymouth,12,2988,Hinton Comm School District,7,40,47,85.1
45,Howard,1,3029,Howard-Winneshiek Comm School District,19,57,76,75
42,Hardin,7,3033,Hubbard-Radcliffe Comm School District,12,48,60,80
7,Black Hawk,7,3042,Hudson Comm School District,10,54,64,84.4
46,Humboldt,5,3060,Humboldt Comm School District,22,84,106,79.2
10,Buchanan,7,3105,Independence Comm School District,21,69,90,76.7
91,Warren,11,3114,Indianola Comm School District,56,230,286,80.4
61,Madison,11,3119,Interstate 35 Comm School District,10,40,50,80
52,Johnson,10,3141,Iowa City Comm School District,243,654,897,72.9
42,Hardin,7,3150,Iowa Falls Comm School District,16,76,92,82.6
48,Iowa,10,3154,Iowa Valley Comm School District,7,26,33,78.8
14,Carroll,13,3168,IKM-Manning Comm School District,12,33,45,73.3
9,Bremer,7,3186,Janesville Consolidated School District,3,23,26,88.5
37,Greene,5,3195,Greene County Comm School District,19,80,99,80.8
10,Buchanan,7,3204,Jesup Comm School District,7,53,60,88.3
77,Polk,11,3231,Johnston Comm School District,54,459,513,89.5
56,Lee,15,3312,Keokuk Comm School District,44,61,105,58.1
54,Keokuk,15,3330,Keota Comm School District,6,21,27,77.8
75,Plymouth,12,3348,Kingsley-Pierson Comm School District,10,28,38,73.7
63,Marion,11,3375,Knoxville Comm School District,14,94,108,87
95,Winnebago,7,3420,Lake Mills Comm School District,12,40,52,76.9
27,Decatur,13,3465,Lamoni Comm School District,5,24,29,82.8
76,Pocahontas,5,3537,Laurens-Marathon Comm School District,6,7,13,53.8
97,Woodbury,12,3555,Lawton-Bronson Comm School District,4,38,42,90.5
75,Plymouth,12,3600,Le Mars Comm School District,19,143,162,88.3
87,Taylor,13,3609,Lenox Comm School District,5,22,27,81.5
78,Pottawattamie,13,3645,Lewis Central Comm School District,56,138,194,71.1
16,Cedar,10,3691,North Cedar Comm School District,17,32,49,65.3
57,Linn,10,3715,Linn-Mar Comm School District,73,465,538,86.4
57,Linn,10,3744,Lisbon Comm School District,2,49,51,96.1
43,Harrison,13,3798,Logan-Magnolia Comm School District,3,41,44,93.2
52,Johnson,10,3816,Lone Tree Comm School District,13,26,39,66.7
58,Louisa,9,3841,Louisa-Muscatine Comm School District,16,43,59,72.9
55,Kossuth,5,3897,LuVerne Comm School District,0,0,0,
50,Jasper,11,3906,Lynnville-Sully Comm School District,3,35,38,92.1
8,Boone,11,3942,Madrid Comm School District,11,51,62,82.3
65,Mills,13,3978,East Mills Comm School District,9,22,31,71
13,Calhoun,5,4023,Manson Northwest Webster Comm School District,5,43,48,89.6
67,Monona,12,4033,Maple Valley-Anthon Oto Comm School District,15,19,34,55.9
49,Jackson,9,4041,Maquoketa Comm School District,26,73,99,73.7
28,Delaware,1,4043,Maquoketa Valley Comm School District,8,48,56,85.7
18,Cherokee,12,4068,Marcus-Meriden-Cleghorn Comm School District,0,0,0,
57,Linn,10,4086,Marion Independent School District,23,130,153,85
64,Marshall,7,4104,Marshalltown Comm School District,97,164,261,62.8
91,Warren,11,4122,Martensdale-St Marys Comm School District,7,36,43,83.7
17,Cerro Gordo,7,4131,Mason City Comm School District,50,181,231,78.4
84,Sioux,12,4149,MOC-Floyd Valley Comm School District,18,58,76,76.3
29,Des Moines,15,4203,Mediapolis Comm School District,9,45,54,83.3
63,Marion,11,4212,Melcher-Dallas Comm School District,6,20,26,76.9
53,Jones,10,4269,Midland Comm School District,7,23,30,76.7
92,Washington,10,4271,Mid-Prairie Comm School District,18,75,93,80.6
43,Harrison,13,4356,Missouri Valley Comm School District,20,50,70,71.4
22,Clayton,1,4419,MFL MarMac Comm School District,12,34,46,73.9
79,Poweshiek,7,4437,Montezuma Comm School District,5,27,32,84.4
53,Jones,10,4446,Monticello Comm School District,20,73,93,78.5
4,Appanoose,15,4491,Moravia Comm School District,11,20,31,64.5
93,Wayne,13,4505,Mormon Trail Comm School District,8,8,16,50
58,Louisa,15,4509,Morning Sun Comm School District,7,8,15,53.3
4,Appanoose,15,4518,Moulton-Udell Comm School District,4,12,16,75
80,Ringgold,13,4527,Mount Ayr Comm School District,11,35,46,76.1
44,Henry,15,4536,Mount Pleasant Comm School District,51,90,141,63.8
57,Linn,10,4554,Mount Vernon Comm School District,10,87,97,89.7
20,Clarke,13,4572,Murray Comm School District,7,16,23,69.6
70,Muscatine,9,4581,Muscatine Comm School District,118,255,373,68.4
9,Bremer,7,4599,Nashua-Plainfield Comm School District,8,37,45,82.2
85,Story,11,4617,Nevada Comm School District,28,86,114,75.4
11,Buena Vista,5,4644,Newell-Fonda Comm School District,2,26,28,92.9
19,Chickasaw,1,4662,New Hampton Comm School District,12,56,68,82.4
44,Henry,15,4689,New London Comm School District,7,26,33,78.8
50,Jasper,11,4725,Newton Comm School District,64,147,211,69.7
98,Worth,7,4772,Central Springs Comm School District,5,35,40,87.5
23,Clinton,9,4773,Northeast Comm School District,5,52,57,91.2
33,Fayette,1,4774,North Fayette Comm School District,0,0,0,
40,Hamilton,5,4775,Northeast Hamilton Comm School District,0,0,0,
62,Mahaska,15,4776,North Mahaska Comm School District,3,25,28,89.3
57,Linn,10,4777,North Linn Comm School District,12,45,57,78.9
55,Kossuth,5,4778,North Kossuth Comm School District,13,33,46,71.7
77,Polk,11,4779,North Polk Comm School District,8,119,127,93.7
82,Scott,9,4784,North Scott Comm School District,41,187,228,82
86,Tama,7,4785,North Tama County Comm School District,9,27,36,75
96,Winneshiek,1,4787,North Winneshiek Comm School District,1,9,10,90
98,Worth,7,4788,Northwood-Kensett Comm School District,11,29,40,72.5
91,Warren,11,4797,Norwalk Comm School District,19,144,163,88.3
81,Sac,5,4860,Odebolt-Arthur Comm School District,7,60,67,89.6
33,Fayette,1,4869,Oelwein Comm School District,34,49,83,59
8,Boone,11,4878,Ogden Comm School District,7,46,53,86.8
30,Dickinson,5,4890,Okoboji Comm School District,12,51,63,81
53,Jones,10,4905,Olin Consolidated School District,0,0,0,
1,Adair,13,4978,Orient-Macksburg Comm School District,small N,small N,small N,small N
66,Mitchell,7,4995,Osage Comm School District,14,45,59,76.3
62,Mahaska,15,5013,Oskaloosa Comm School District,77,98,175,56
90,Wapello,15,5049,Ottumwa Comm School District,73,199,272,73.2
39,Guthrie,11,5121,Panorama Comm School District,12,51,63,81
37,Greene,5,5139,Paton-Churdan Comm School District,2,10,12,83.3
50,Jasper,11,5160,PCM Comm School District,11,74,85,87.1
54,Keokuk,15,5163,Pekin Comm School District,12,38,50,76
63,Marion,11,5166,Pella Comm School District,26,136,162,84
25,Dallas,11,5184,Perry Comm School District,26,68,94,72.3
82,Scott,9,5250,Pleasant Valley Comm School District,31,285,316,90.2
63,Marion,11,5256,Pleasantville Comm School District,7,38,45,84.4
76,Pocahontas,5,5283,Pocahontas Area Comm School District,10,42,52,80.8
3,Allamakee,1,5310,Postville Comm School District,16,30,46,65.2
94,Webster,5,5325,,0,0,0,
69,Montgomery,13,5463,Red Oak Comm School District,19,51,70,72.9
75,Plymouth,12,5486,Remsen-Union Comm School District,5,10,15,66.7
45,Howard,1,5508,Riceville Comm School District,2,23,25,92
78,Pottawattamie,13,5510,Riverside Comm School District,14,27,41,65.9
84,Sioux,12,5607,Rock Valley Comm School District,9,44,53,83
85,Story,11,5643,Roland-Story Comm School District,11,68,79,86.1
34,Floyd,7,5697,Rudd-Rockford-Marble Rk Comm School District,7,29,36,80.6
74,Palo Alto,5,5724,Ruthven-Ayrshire Comm School District,5,8,13,61.5
66,Mitchell,7,5751,St Ansgar Comm School District,3,47,50,94
77,Polk,11,5805,Saydel Comm School District,26,61,87,70.1
81,Sac,5,5823,Schaller-Crestland Comm School District,7,35,42,83.3
24,Crawford,12,5832,Schleswig Comm School District,2,16,18,88.9
97,Woodbury,12,5877,Sergeant Bluff-Luton Comm School District,28,95,123,77.2
93,Wayne,15,5895,Seymour Comm School District,3,14,17,82.4
17,Cerro Gordo,7,5922,West Fork CSD,22,29,51,56.9
71,O'Brien,12,5949,Sheldon Comm School District,6,64,70,91.4
73,Page,13,5976,Shenandoah Comm School District,19,49,68,72.1
72,Osceola,12,5994,Sibley-Ocheyedan Comm School District,15,51,66,77.3
36,Fremont,13,6003,Sidney Comm School District,5,26,31,83.9
54,Keokuk,15,6012,Sigourney Comm School District,9,35,44,79.5
84,Sioux,12,6030,Sioux Center Comm School District,14,64,78,82.1
11,Buena Vista,5,6035,Sioux Central Comm School District,15,40,55,72.7
97,Woodbury,12,6039,Sioux City Comm School District,252,669,921,72.6
13,Calhoun,5,6091,South Central Calhoun Comm School District,6,54,60,90
52,Johnson,10,6093,Solon Comm School District,14,92,106,86.8
91,Warren,11,6094,Southeast Warren Comm School District,4,33,37,89.2
40,Hamilton,5,6095,South Hamilton Comm School District,11,48,59,81.4
94,Webster,5,6096,Southeast Webster Grand Comm School District,18,52,70,74.3
73,Page,13,6097,South Page Comm School District,small N,small N,small N,small N
86,Tama,7,6098,South Tama County,40,65,105,61.9
71,O'Brien,12,6099,South O'Brien Comm School District,6,38,44,86.4
96,Winneshiek,1,6100,South Winneshiek Comm School District,3,19,22,86.4
77,Polk,11,6101,Southeast Polk Comm School District,112,398,510,78
21,Clay,5,6102,Spencer Comm School District,16,121,137,88.3
30,Dickinson,5,6120,Spirit Lake Comm School District,9,66,75,88
57,Linn,10,6138,Springville Comm School District,10,19,29,65.5
69,Montgomery,13,6165,Stanton Comm School District,4,16,20,80
33,Fayette,1,6175,Starmont Comm School District,13,27,40,67.5
11,Buena Vista,5,6219,Storm Lake Comm School District,68,97,165,58.8
40,Hamilton,5,6246,Stratford Comm School District,0,0,0,
39,Guthrie,11,6264,West Central Valley Comm School District,5,53,58,91.4
9,Bremer,7,6273,Sumner-Fredericksburg Comm School District,7,50,57,87.7
16,Cedar,10,6408,Tipton Comm School District,16,65,81,80.2
78,Pottawattamie,13,6453,Treynor Comm School District,10,50,60,83.3
78,Pottawattamie,13,6460,Tri-Center Comm School District,9,48,57,84.2
54,Keokuk,15,6462,Tri-County Comm School District,7,10,17,58.8
9,Bremer,7,6471,Tripoli Comm School District,9,29,38,76.3
96,Winneshiek,1,6509,Turkey Valley Comm School District,0,15,15,100
63,Marion,11,6512,Twin Cedars Comm School District,9,13,22,59.1
46,Humboldt,5,6516,Twin Rivers Comm School District,0,0,0,
78,Pottawattamie,13,6534,Underwood Comm School District,17,43,60,71.7
7,Black Hawk,7,6536,Union Comm School District,14,64,78,82.1
8,Boone,11,6561,United Comm School District,0,0,0,
77,Polk,11,6579,Urbandale Comm School District,51,242,293,82.6
33,Fayette,1,6591,Valley Comm School District,11,71,82,86.6
89,Van Buren,15,6592,Van Buren Comm School District,15,33,48,68.8
25,Dallas,11,6615,Van Meter Comm School District,6,39,45,86.7
69,Montgomery,13,6651,Villisca Comm School District,11,31,42,73.8
6,Benton,10,6660,Vinton-Shellsburg Comm School District,6,96,102,94.1
44,Henry,15,6700,Waco Comm School District,10,19,29,65.5
81,Sac,5,6741,East Sac County Comm School District,13,47,60,78.3
58,Louisa,15,6759,Wapello Comm School District,19,30,49,61.2
9,Bremer,7,6762,Wapsie Valley Comm School District,14,37,51,72.5
92,Washington,10,6768,Washington Comm School District,29,80,109,73.4
7,Black Hawk,7,6795,Waterloo Comm School District,202,460,662,69.5
25,Dallas,11,6822,Waukee Comm School District,81,597,678,88.1
9,Bremer,7,6840,Waverly-Shell Rock Comm School District,18,157,175,89.7
93,Wayne,15,6854,Wayne Comm School District,6,30,36,83.3
40,Hamilton,5,6867,Webster City Comm School District,22,95,117,81.2
74,Palo Alto,5,6921,West Bend-Mallard Comm School District,9,21,30,70
16,Cedar,10,6930,West Branch Comm School District,16,48,64,75
29,Des Moines,15,6937,West Burlington Ind School District,21,45,66,68.2
33,Fayette,1,6943,West Central Comm School District,3,11,14,78.6
28,Delaware,1,6950,West Delaware County Comm School District,20,114,134,85.1
77,Polk,11,6957,West Des Moines Comm School District,138,527,665,79.2
31,Dubuque,1,6961,Western Dubuque Comm School District,19,203,222,91.4
43,Harrison,13,6969,West Harrison Comm School District,6,20,26,76.9
70,Muscatine,9,6975,West Liberty Comm School District,17,56,73,76.7
60,Lyon,12,6983,West Lyon Comm School District,7,58,65,89.2
64,Marshall,7,6985,West Marshall Comm School District,11,62,73,84.9
67,Monona,12,6987,West Monona Comm School District,19,29,48,60.4
84,Sioux,12,6990,West Sioux Comm School District,16,41,57,71.9
97,Woodbury,12,6992,Westwood Comm School District,8,20,28,71.4
67,Monona,12,7002,Whiting Comm School District,4,10,14,71.4
48,Iowa,10,7029,Williamsburg Comm School District,8,68,76,89.5
70,Muscatine,9,7038,Wilton Comm School District,16,43,59,72.9
44,Henry,15,7047,Winfield-Mt Union Comm School District,3,28,31,90.3
61,Madison,11,7056,Winterset Comm School District,16,81,97,83.5
43,Harrison,13,7092,Woodbine Comm School District,10,24,34,70.6
97,Woodbury,12,7098,Woodbury Central Comm School District,11,40,51,78.4
25,Dallas,11,7110,Woodward-Granger Comm School District,8,52,60,86.7
,,,,,,,,
,,,,Total,7968,25335,33303,76.1